NO ./img/north.xpm
SO ./img/south.xpm
WE ./img/west.xpm
EA ./img/west.xpm

F 255,0,0
WE ./img/west.xpm

C 255,54,0
F 105,190,40


NO ./img/north.xpm

        1111111111111111111111111
        10000000001100000000000001
        1011000001110001111000001
        1001000000000001  1000001
111111111011000001110001111000001
100000000011000001110111111111111
111101111111111011100000010001
11110111111111011101010010001
11000000110101011100000010001
100000000000000011000000100011
1000000000000000110101001000001
11000001110101011111011110W00011
11110111 1110101 101111010000111
11111111 1111111 111111111111
